SO ./textures/1green_s.png
NO ./textures/1green_n.png
WE ./textures/1green_w.png
EA ./textures/1green_e.png


C 47,79,47

F 97,97,97

                            1111111111111111111111111111111111111							
                            1000000000000000000000000000000000011	
                            1111111111111111111011111111111111111
                                            111011
1111111111111111111111111                     101
1000000000000000000000001                     101
1000000000000001100000001                     101
1000000000000000100000001                     101
1000000100000000000000001                     101
1000000000110000010101001                     101
1011000001110000110101001                     101
10010000000000000111011011111111111111111111111011111111
111111111011000001110000000000000000000000000000000000111
100000000011000001110111111111111111110011111111111111
1111011111111101110000001            1001
1111011111111101110000111            1001
11111111110000001101010111111111     1001
       1000000000E00000000000001     1001
11111111100000000000000011111111     1001
1100000111010101111101111            1001
1111011111110101101111011            1001
1111111111111111111111111            1001
                                     1001
                                     1111





