SO ./textures/South.png
NO ./textures/North.png
WE ./textures/West.png
EA ./textures/East.png
C 0,85,164
F 239,65,53




1111111111111111111111111111
1000000000000000000000000001
1000000000000000000000000001
1000000000000000000000000001
10000000000000N0000000000001
1000000000000000000000000001
1000000000000000000000000001
1000000000000000000000000001
1111111111111111111111111111