NO ./textures/North.png
SO ./textures/South.png
WE ./textures/West.png
EA ./textures/East.png


F 300,100,0
C 225,30,0


1111111111111111111111111
1000000000110000000000001
10110000011100000000N0001
1001000000000000000000001
1111111110110000011100001
1000000000110000011101111
1111011111111101110000001
1111011111111101110101001
1100000011010101110000001
1000000000000000110000001
1000000000000000110101001
1100000111010101111101111
1111011111110101101111011
1111111111111111111111111