NO ./textures/North.png
SO ./textures/South.png
WE ./textures/West.png
EA ./textures/East.png
F 220,100,0
C 225,30,0
   1111111111111111111111111
   1000000000110000000000001
   101100000111000000000N001
   1001000000000000000000001
1111111110110000011100001111
1000000000110000011101111
1111011111111101110000001
1111011111111101110101001
1100000011010101110000001
100000000000AAAAAAAAAA001
1000000000000000110101000
1100000111010101111101111
1111011111110101101111011
1111111111111111111111111