NO ./textures/North.png
SO ./textures/South.png
WE ./textures/West.png
EA ./textures/East.png
F 220,100,0
C 45,45,45
    111111111111111111111111
    100000000011000000000000
    101100000111000000000000
    100100000000000000000000
11111111101100000111000000000000
10000000001100000111011111111111
1111011111111101110000000000
1111011111111101110101001000
1100000011010101110000001000
1000000000000000110000001000
1000000000000000110101001000
11000001110101011111011110N011
11110111 1110101 10111101000
11111111 1111111 11111111111